NO ./path_to_the_north_texture

SO ./path_to_the_south_texture

WE ./path_to_the_west_texture

EA ./path_to_the_east_texture


F 220,100,0

C 225,30,0


111111 101
10W001 101
110001110111
100001 10001
111111111111
