NO    ./path_to_the_north_texture
SO   ./path_to_the_south_texture
WE  ./path_to_the_west_texture
EA ./path_to_the_east_texture

F 220,100,0
C 225,30,0


        1111111111111111111111111
  111   1000000000110000001000001
  111   1000000000110000010000001
        100100W000000000100000001
111111111011000001110000000000001
100000000011000001110110111111111
11110111111111011100000010001
1111011  11111011101010010001
11000011110101011100000000001
10000000000000001100000000001
10000000000000001101010010001
11000001110101011110111100011
11110111 1110101 101111010001
11111111 1111111 111111111111